The Rolling Stones - Dead Flowers (Live) - OFFICIAL
Traveling Wilburys - End Of The Line
Millencolin- Story Of My Life
Dia psalma - Gryningsvisa i D-moll
Bryan Adams - Can't Stop This Thing We Started
Michael Jackson - Black Or White
TALLEST MAN ON EARTH // the dreamer
Dixie Chicks - Cowboy Take Me Away
Willy Clay Band - Mighty Good Time
Waylon Jennings - Are You Sure Hank Done It This Way
Turnpike Troubadours   1968
Eric Church - Without You Here Lyrics
The Beatles-Hey Jude
(Marie's the Name) His Latest Flame
Ramones-Blitzkrieg Bop
Nationalteatern - Men bara om min älskade väntar
Longview - Green Day + Lyrics
Christian Kjellvander - Poppies and Peonies
Death Cab for Cutie &quot;I Will Follow You Into The Dark&quot; (Acoustic)
Ben Gibbard - Such Great Heights (Live 11/15/2014)
Mando Diao - Sheepdog (Official Video)
THE ROLLING STONES /// 9. Dead Flowers - (Sticky Fingers) - (1971)
Guns N' Roses - Rocket Queen (Music Video)
Slipknot - (Sic) (Audio)
oasis - i hope, i think, i know
Me and My Army - Thank god for sending demons (Moraeus med mera)
Israel Nash Gripka - Fool's Gold @ Binnendieze Den Bosch 2012
Sólstafir - Fjara (Official Video)
The White Stripes - You Don't Know What Love Is [You Just Do As You're Told]
The White Buffalo | &quot;Sleepy Little Town&quot; (The Living Room Sessions: Bonus Session)
Warren Zevon - Roland the Headless Thompson Gunner
Totta Näslund - Kosters klippor
Klinga mina klockor
Sublime - Wrong Way
Steve Earle - Guitar Town
The Soundtrack Of Our Lives - Instant Repeater '99
Oh My Sweet Carolina
Refused - New Noise (video)
Old Friend - Rancid
Raised Fist - Friends And Traitors (Official Video)
Pearl Jam - Just Breathe (Lyrics)
Old Crow Medicine Show - Wagon Wheel [Official Music Video]
Couldn't have said it better [w/Lyrcis]
Kungers - Fenyletylamin (Kongressen)
Kent - Utan Dina Andetag (ENG/SV Lyrics)
Justin Townes Earle - Harlem River Blues - album version
Kaizers Orchestra - Hjerteknuser (Official HD 1080p w/ English subs)
Coal War - Joshua James (with lyrics)
Creedence Clearwater Revival - Long as I Can See the Light
Håkan Hellström - För sent för Edelweiss
Hate to Say I Told You So
The Gaslight Anthem - &quot;Great Expectations&quot; (official video)
Foo Fighters - These Days
Elton John - Tiny Dancer
Drive-By Truckers- Birthday Boy
Dog Almighty Borås
Daryl Hall &amp; John Oates - You Make My Dreams
The Darkness - I Believe In A Thing Called Love (Official Music Video)
Band of Horses - &quot;Marry Song&quot; (HD)
The Band, The Weight
The Avett Brothers - Shame
Arctic Monkeys - Fluorescent Adolescent Lyrics
Jake Bugg - Me And You (Audio)
Social Distortion - Don't Take Me For Granted
Daniel Norgren - Whatever Turns You On (Studio Live)
Sturgill Simpson - The Promise
Jeff Healey - Jambalaya
Metallica - Nothing Else Matters